WWWWWWWWWWWWWWWWWWWWWWWWWWWWWWWWWWW
W    W    W                       W
W    W    W     WWWWWWWWWWWWWWWW  W
W    W          W                 W
W    W    W     W  WWWWWWWWWWWWWWWW
W    W    W     W                 W
W    W    WWWWWWWWWWWWWWWWWWWWWW  W
W    W    W     W     W           W
W    W    W  W WWWWW  W  WWWWWWWWWW
W    W       W     W  W           W
WWW WWWWWWWWWW  P  WWWWWWWWWWWWW WW
W         W  W     W  W      W    W
WWWWWWWW  W  WWWWWWW  W      W    W
W         W     W     W      W    W
W  WWWWWWWWWWWWWWWWWWWW      W    W
W               W            W    W
WWWWWWWWWWWWWW  W     W      W    W
W               W     W      W    W
W  WWWWWWWWWWWWWW     W      W    W
W                     W           W
WWWWWWWWWWWWWWWWWWWWWWWWWWWWWWWWWWW