WWWWWWWWWWWWWWWWWWWWWWWWWWWWWWWWWWW
W    W   W        W       W     WWW
W    WWWWW   WWWWWW       WWW     W
W    W       W                    W
W    W    WWWW       WWWWwWW      W
W    W    WWWW       W            W
W                WWWWWWWWWWW      W
W                W                W
WWWWWWWWWWWWWWWWWW     WW   WWWWWWW
W                       W   W     W
W   WWWWW        WWWWWWWWWWWW     W
WWWWW       WWWWWW                W
W      WWW  W               W     W
W    W      WWWWWWWWWWWWWWWWW     W
W    W      W                     W
W    WWWWWWWW                     W
W    WWW    WWWW   WWWWWW  WWWWWWWW
W      W    W      W              W
W      W           W              W
W           WWWWWWWW       P     WW
WWWWWWWWWWWWWWWWWWWWWWWWWWWWWWWWWWW