WWWWWWWWWWWWWWWWWWWWWWWWWWWWWWWWWWW
W                                 W
W              WWWWWW   W     WWWWW
WWWWWWWWWWWWWWWW        W         W
W     W      P W        WWWWWWWWWWW
W  W     W     W                  W
W  WWWWWWWWWWWWWWWWWWWWWWWWWWWW   W
W         W     W    W        W   W
WWWWWWWW  W  W  W        W    W   W
W         W  W  W    W   W    W   W
W  WWWWWWWW  W  W    W   W    W   W
W            W  W     WWWW    W   W
WWWWWWWWWWWWWW  W       W     W   W
W               W       W     W   W
W  WWWWWWWWWWWWWW       W     W   W
W                       W     W   W
WWWWWWWWWWWWWWWWWWWWWWWWW     W   W
W                             W   W
W       WWWWWWWWWWWWWWWWWWWWWWW   W
W                                 W
WWWWWWWWWWWWWWWWWWWWWWWWWWWWWWWWWWW