WWWWWWWWWWWWWWWWWWWWWWWWWWWWWWWWWWW
W     W                           W
W     W        WWWWW    W         W
WWW WWWWWWWW       W    WWWWWWWW  W
W    W             WWWWWW         W
W    W    WWWWWWWWWWWWWWWWWWW     W
W    W    W           W           W
W         W       W               W
WWWWWWWWWWWWWWW WWWWWWWWWWWWWW  WWW
W   W              W         W    W
W   W        W     WWW       W    W
W            W          WWWWWW    W
W   W     W WWWWWWWWWWWWW         W
WWWWW     W        W    WWWW      W
W         W   WWWWWW    W  W      W
WWWWWWWWWWW        W        WW    W
W                  W         W    W
W          WWWWWWWWWWWWWW    W    W
W   P      W                 W    W
W          W      W               W
WWWWWWWWWWWWWWWWWWWWWWWWWWWWWWWWWWW