WWWWWWWWWWWWWWWWWWWWWWWWWWWWWWWWWWW
W          W                      W
W          W       WWWWW          W
W         W       W     W         W
W        W         W     W        W
W   WW             W      W       W
WWWW  WW        WWW        W      W
W       WWWWWWWW           W      W
WW                         W      W
WWW  WWWWWWW      W        W      W
WWWWW       W    W   W     W      W
WWWW    W    WWWW   W      W      W
WWW    W W         W      W       W
WW    W   WWWW      WWWWWW       WW
W    W   P    W                 W W
W    W         WWW   WWWW      W  W
W    W            WWW    WWWWW W  W
W   W       W     W        W     WW
W    WWWWWWW      WW      W     WWW
W                WW W          WWWW
WWWWWWWWWWWWWWWWWWWWWWWWWWWWWWWWWWW