WWWWWWWWWWWWWWWWWWWWWWWWWWWWWWWWWWW
W      W     WwWWWWWWWWW        WWW
W      W      W   WWWWWW   P    WWW
W      WWW    W     WWW          WW
W             W     WW            W
WWWWWW   WWWWWW     WWWWWWW  WWWWWW
W          W        WWWWW         W
W         W          WWWW         W
W        W    WW      WWW     WWWWW
W        W   W  W      W      W   W
W    W    W    W      WWWW  WWW   W
W    W     WWWW   WWWW     W      W
W    W            W       W       W
WWWWWWWWWWWW      W               W
W       W         WWWWW   W       W
W   W   W     WWWWW   W   W       W
W   WWWWW              WWWWWWWWWW W
W   W              WW             W
W   WWWWWWW     WW WWWWWW         W
W             WWW       WWWW      W
WWWWWWWWWWWWWWWWWWWWWWWWWWWWWWWWWWW