WWWWWWWWWWWWWWWWWWWWWWWWWWWWWWWWWWW
WWW           WWWWW  W            W
WW       W           W     WWWW   W
W        W      WWWWW  W      W   W
WWWWW WWWWWWWWWWW       WWWWWWW   W
W           W                     W
WWWWWWWWWW  WWWWWWWWWWWWWWWWWWWWWWW
W           W                 W   W
W     W     WWWW WWWW         W   W
W     WWWWWWW       WWWWWW WWWW   W
W           W   P        W   W    W
W     WW    W       W    W   W    W
W  W   W    WWWWWWWWW    W        W
W  W   W        W        WWWW WWWWW
WWWWWWWW   WWWWWW   WWWWWW        W
W      W        W   W             W
W      W        WWWWW             W
W  WWW                   WWWWWWWWWW
W        WWWWWWW        W     W   W
W              W          W  W    W
WWWWWWWWWWWWWWWWWWWWWWWWWWWWWWWWWWW