WWWWWWWWWWWWWWWWWWWWWWWWWWWWWWWWWWW
W                                 W
W                                 W
WWWWWWWWWWWWWWWW  WWWWWWWWWWWWWWWWW
W             W    W              W
W   W         W    W         W    W
W    WWWWWWWWW      WWWWWWWWW     W
W                                 W
WWWW WWWWWWWWWWWWWWWWWWWWWWWWW WWWW
W                          W      W
W               WWWWWW     W      W
WWWWWWWWWWWWWWWWWW   W     W      W
W                    W     W      W
W       WWWWWWWWWW         W      W
W       W        W         W      W
W       W  WWW WWWWWWWWWWWWW      W
W   WWWWWWWW          W    W      W
W          W          W    W      W
W     W          P    W           W
W     W    W          W           W
WWWWWWWWWWWWWWWWWWWWWWWWWWWWWWWWWWW