WWWWWWWWWWWWWWWWWWWWWWWWWWWWWWWWWWW
W                    W            W
W       WWWWWWWWWW   W   P     W  W
WWWWWWWWW        W   WWWWWWWWWWW  W
W         WWWW   W   W            W
W            W   W   W  WWWWWWWWWWW
WWWWWWWWWW   W   W   W            W
W        W   W   W   W   WWWWWWW  W
W   W        W       W      W     W
WW  WWWWWWWWWWWWWWWWWWWWWWWWW   WWW
W             W     W     WWWW WWWW
WWWWWWWWWWWW  W  W  W  W  W       W
W          W  W  W  W  W  W  WWWWWW
W   W         W  W  W  W  W       W
W  WWWWWWWWWWWW  W  W  W  WWWWWW  W
W             W  W  W  W  W       W
WWWWWWWWWWWW  W  W  W  W  W  WWWWWW
W             W  W  W  W  W       W
W  WWWWWWWWWWWW  W  W  W  WWWWWW  W
W                W     W          W
WWWWWWWWWWWWWWWWWWWWWWWWWWWWWWWWWWW